OPPPPPPPPPPPPPPP
OPPPPPPPPPPP00BP
OPPAAAAAAAPP0PPP
OPPPPPPPPPPP00PP
OPPZ0II00000000P
OPP00II0PPP0000O
OPP00II00PP0000O
OPP00III0PP00IIO
OPP00II00PP0IIQO
OB0000000PP0000O
OPPPOOOOOOOOIIIO
OOOOOOOOOOOOOOOO