PPPPPPPPPPPPPPPP
PZP000000000000P
P0P0PPPPPPPPPP0P
P0P0P00000000P0P
P0P0P0PPPPPP0P0P
P0P0P0PPPPQP0P0P
P0P0P000000P0P0P
P0P0PPPPPPPP0P0P
P0P0000000000P0P
P0PPPPPPPPPPPP0P
P00000000000000P
PPPPPPPPPPPPPPPP