0000000000000000
OOOOOOOOOOOOOOOO
NZ000000000000NO
ONNNNNNNNNNNI0OO
NI000000000000NO
NB0PPPPPPPPPPPNO
NI0000000000BPNO
NK0000IIIM0I00NO
N00M00000000M0NO
N00MPPPP000000NO
N000PPQ0000000NO
OOOOOOOOOOOOOOOO