PPPPPPPPPPPPPPPP
PPPPPPPPPPPPPPPP
PPOOOOOOOOOOOOPP
PPO000NNNN000NPP
PPNZ000000000NPP
PPN0000MM000QNPP
PPN0000MM000QNPP
PPNB000000000NPP
PPN000NNNN000NPP
PPOOOOOOOOOOOOPP
PPPPPPPPPPPPPPPP
PPPPPPPPPPPPPPPP