PPPPPPPPPPPPPPPP
PPPPPPPPPPPPPPPP
PPOOONPPPPNOOOPP
PPO000PB00000NPP
PPN000PPPP000NPP
PZ0000000000000Q
P00000000000000Q
PPN000PPPP000NPP
PPN000PB00000NPP
PPOOOOPPPPOOOOPP
PPPPPPPPPPPPPPPP
PPPPPPPPPPPPPPPP