NNNNPPPPPPPPNNNN
N0BIPPNNNNPPIQ0N
N0IIOOOIIOOOII0N
N00000000000000N
PPN000IIII000NPP
PPN0M0IPPI0M0NPP
PPN0M0IPPI0M0NPP
PPN000IIII000NPP
N00000000000000N
N0IIOOOIIOOOII0N
N0BIPPNNNNPPIQ0N
NNNNPPPPPPPPNNNN