NNNNPPQQQQPPNNNN
NZIIPPPPPPPP000N
N0IQP00000000I0N
N0IB00IIIMIIII0N
P0IIII000I00000P
P0000I0P000PB00P
PPPP0I0PPPPPPPPP
P0000I000000000P
N0IIIIIIIIIIII0N
N0I000I000000I0N
N000P000PPBP000N
NNNNPPPPPPPPNNNN