OOOOOOOOOOOOOOOO
OOOOOOOOOOOOOOOO
OOZ00000000000OO
PPPPPPPPPPPPP0OO
PPB0000000QP00IO
OOIIIIIII00P0IBI
OOI0000I00IP0I0I
OO00PI000IIP000I
OOP0PPPPPPPPP0OO
OOP00000000000OO
OOOOOOOOOOOOOOOO
OOOOOOOOOOOOOOOO