PPPPPPPPPPPPPPPP
PPPPPPPPPPPPPPPP
PPOOONPPPPNOOOPP
PPO000PPPP000NPP
PPN00BPPPPQ00NPP
PPN0000000000NPP
PPN0000000000NPP
PPN00ZPPPPQ00NPP
PPN000PPPP000NPP
PPOOOOPPPPOOOOPP
PPPPPPPPPPPPPPPP
PPPPPPPPPPPPPPPP