PPPPOOOOOOOOPPPP
P00000OOOO00000P
P00000ZIQ000000P
P0PPPPPPP0PPPP0P
O000PIIII0IP000O
OOI0PB00I00P0IOO
OOI0PBI0II0P0IOO
O000PBI0000P000O
P0PPPPPPPPPPPP0P
P0P0000000000P0P
P000PPOOOOPP000P
PPPPOOOOOOOOPPPP